R 1000 1000

NO ../xpm/norr.xpm
SO ../xpm/south.xpm    
WE ../xpm/weest.xpm
EA ../xpm/east1.xpm
S ./path_to_the_sprite_texture
F 225,255,255
C 225,0,255

1111111111111111111111111111111111111111111111111
1000001100000000000000000000000000000000000000001
1000000000000000000000000000000000000000000000001
1000000000000000000000000000000000000000000000001
1000000000000000000000000000000000000000000000001
1000000000111111111111011111111111111000000000001
1000000000000000000000000000000000000000000000001
1000000000000000000000000000000000000000000000001
1000000000000000000000000000000000000000000000001
1000000000000000000000000000000000000000000000001
1000001111111111111111111111111111111111111000001
1000001                1                  1000001
1000001               121                 1000001
1000001                1                  1000001
1000001111111111111111111111111111111111111000001
1000000000000000000000000000000000000000000000001
1000000000000000000000000000000000000000000000001
10000000000000000000000000000000000000000000000N1
1111111111111111111111111111111111111111111111111