R 1000 1000
NO ./path_to_the_north_texture
SO ./path_to_the_south_texture

WE ./path_to_the_west_texture
EA ./path_to_the_east_texture
S ./path_to_the_sprite_texture
F 220,100,0
C 225,30,0

111111111              111111111
100000001              100000001
100000001              100000001
100000001              100000001
111100001              100001111
   1000001            1000001
    1000001          1000001
     1000001        1000001
      1000001      1000001
       1000001    1000001
        1000001  1000001
         1000001100000011111111111111111111111111111111111
         1000000000000000000000000000000000000000000000001
         1000000000000000000000000000000000000000000000001
         1000000000000000000000000000000000000000000000001
         1000000000111111111111011111111111111000000000001
         1000000000000000000000000000000000000000000000001
         1000000000000000000000000000000000000000000000001
         1000000000000000000000000000000000000000000000001
         1000000000000000000000000000000000000000000000001
         1000001111111111111111111111111111111111111000001
         1000001                1                  1000001
         1000001               121                 1000001
         1000001                1                  1000001
         1000001111111111111111111111111111111111111000001
         1000000000000000000000000000000000000000000000001
         1000000000000000000000000000000000000000000000001
         10000000000000000000000000000000000000000000000N1
         1111111111111111111111111111111111111111111111111