R 1000 1000

NO ./textures/norr.xpm
SO ./textures/south.xpm
WE ./textures/weest.xpm
EA ./textures/east1.xpm

S ./path_to_the_sprite_texture
F 0,255,255
C 0,0,255

                          111111111111111111111111111111111111111111111111111111111
                          100000000000000000000000000000000000000000000000000000001
                          101111111111111111111111111111111111111111111111111111101
111111111              111101111                                                101
100000001              100000001                                                101
100000001              100000001                                                101
100000001              100000001                                                101
111100001              100001111                                                101
   1000001            1000001                                                   101
    1000001          1000001                                                    101
     1000001        1000001                                                     101
      1000001      1000001                                                      101
       1000001    1000001                                                       101
        1000001  1000001                                                        101
         1000001100000011111111111111111111111111111111111                      101
         1000000000000000000000000000000000000000000000001                      101
         1000000000000000000000000000000000000000000000001                      101
         1000000000000000000000000000000000000000000000001                      101
         1000000000111111111111011111111111111000000000001                      101
         1000000000000000000000000000000000000000000000001                      101
         1000000000000000000000000000000000000000000000001                      101
         1000000000000000000000000000000000000000000000001                      101
         1000000000000000000000000000000000000000000000001                      101
         1000001111111111111111111111111111111111111000001                      101
         1000001                                   1000001                      101
         1000001                                   1000001                      101
         1000001                                   1000001                      101
         1000001111111111111111111111111111111111111000001                      101
         1000000000000000000000000000000000000000000000001                      101
         1000000000000000000000000000000000000000000000001                      101
         1000000000000000000000000000000000000000000000001                      101
         1111111111111111111111110111111111111111111111111                      101
                                101                                             101
                                101                                             101
                                101                                             101
                                101                                             101
                                101                                             101
                                101                                             101
                                101                                             101
                                101                                             101
                                101                                             101
                                101                                             101
                                101                                             101
                                101                                             101
                                101                                             101
                                101                                             101
                                101                                             101
11111111111111111111111111111111101                                             101
10000000000000000000000000000000001                                             101
10000000000000000000000000000000001                                             101
10000000000000000000000000000000001                                             101
10000000000000000000000000000000001                                             101
10000000000000000000000000000000001                                             101
10000000000000000000000000000000001                                             101
10000000000000000000000000000000001                                             101
100000000000000E0000000000000000001                                             101
10000000000000000000000000000000001                                             101
10000000000000000000000000000000001                                             101
10000000000000000000000000000000001                                             101
10000000000000000000000000000000001                                             101
10000000000000000000000000000000001                                             101
10000000000000000000000000000000001                                             101
10000000000000000000000000000000001111111111111111111111111111111111111111111111101
10000000000000000000000000000000000000000000000000000000000000000000000000000000001
11111111111111111111111111111111111111111111111111111111111111111111111111111111111